111111111111111111111
100000000000000000001
101111111110111111101
101000100010100000101
101010101110101110101
100010100000100010101
111110111111101011101
101000100010001000001
101011101011111110111
101000101000000010101
101110101110111010101
101000101010100010001
101011101010111111101
101010001010001000001
101010111011101110111
100010001010001000001
101111101000111011101
101000100010101000101
101010111110101110101
100010000000100000101
111111111111111111111
