111111111111111111111
101000001000001000001
101011101110101010111
101010100010100010001
101010101010111111101
101010001000100000101
101011111111101011101
100010001010001000001
111110101010111111101
100000100010100000101
101011111110101110101
101000000000101000101
101111111111101011111
101000100010001010001
101010101010111010101
100010001010100010101
111111111010101110101
100000001000101000101
101111101111101111101
100000100000000000001
111111111111111111111
